Var1	Var2	Var3
m_Glucose_A[c]	Glucose	A
m_ATP_A[c]	ATP	A
m_Glucose_6_phosphate_A[c]	Glucose-6-phosphate	A
m_ADP_A[c]	ADP	A
m_Fructose_6_phosphate_A[c]	Fructose-6-phosphate	A
m_Fructose_1_6_biphosphate_A[c]	Fructose-1-6-biphosphate	A
m_Glyceraldehyde_3_phosphate_A[c]	Glyceraldehyde-3-phosphate	A
m_Dihydroxyacetone_phosphate_A[c]	Dihydroxyacetone-phosphate	A
m_NAD_A[c]	NAD	A
m_1_3_biphosphoglycerate_A[c]	1-3-biphosphoglycerate	A
m_NADH_A[c]	NADH	A
m_3_phosphoglycerate_A[c]	3-phosphoglycerate	A
m_2_phosphoglycerate_A[c]	2-phosphoglycerate	A
m_Phosphoenol_pyruvate_A[c]	Phosphoenol-pyruvate	A
m_Pyruvate_A[c]	Pyruvate	A
m_Lactate_A[c]	Lactate	A
m_Bicarbonate_A[c]	Bicarbonate	A
m_Oxoloacetate_A[c]	Oxoloacetate	A
m_NAD_AM[c]	NAD	AM
m_Acetyl_CoA_A[c]	Acetyl-CoA	A
m_CO2_A[c]	CO2	A
m_NADH_AM[c]	NADH	AM
m_GTP_A[c]	GTP	A
m_GDP_A[c]	GDP	A
m_2_3_Disphospho_D_glycerate_A[c]	2-3-Disphospho-D-glycerate	A
m_NADP_A[c]	NADP	A
m_6_phosphoglucone_A[c]	6-phosphoglucone	A
m_NADPH_A[c]	NADPH	A
m_6_phosphogluconate_A[c]	6-phosphogluconate	A
m_Ribulose_5_phosphate_A[c]	Ribulose-5-phosphate	A
m_Xylulose_5_phosphate_A[c]	Xylulose-5-phosphate	A
m_Ribose_5_phosphate_A[c]	Ribose-5-phosphate	A
m_Sedoheptulose_7_phosphate_A[c]	Sedoheptulose-7-phosphate	A
m_Erythrose_4_phosphate_A[c]	Erythrose-4-phosphate	A
m_Citrate_A[c]	Citrate	A
m_Cis_aconitate_A[c]	Cis_aconitate	A
m_Isocitrate_A[c]	Isocitrate	A
m_Acetate_A[c]	Acetate	A
m_alpha_ketoglutarate_A[c]	alpha-ketoglutarate	A
m_NADP_AM[c]	NADP	AM
m_NADPH_AM[c]	NADPH	AM
m_Succinyl_CoA_A[c]	Succinyl-CoA	A
m_Succinate_A[c]	Succinate	A
m_FAD_AM[c]	FAD	AM
m_Fumarate_A[c]	Fumarate	A
m_FADH2_AM[c]	FADH2	AM
m_Malate_A[c]	Malate	A
m_Ubiquinone_A[c]	Ubiquinone	A
m_Ubiquinol_A[c]	Ubiquinol	A
m_Hc_A[c]	Hc	A
m_CytCox_A[c]	CytCox	A
m_CytCred_A[c]	CytCred	A
m_O2_A[c]	O2	A
m_Glucose_N[c]	Glucose	N
m_ATP_N[c]	ATP	N
m_Glucose_6_phosphate_N[c]	Glucose-6-phosphate	N
m_ADP_N[c]	ADP	N
m_Fructose_6_phosphate_N[c]	Fructose-6-phosphate	N
m_Fructose_1_6_biphosphate_N[c]	Fructose-1-6-biphosphate	N
m_Glyceraldehyde_3_phosphate_N[c]	Glyceraldehyde-3-phosphate	N
m_Dihydroxyacetone_phosphate_N[c]	Dihydroxyacetone-phosphate	N
m_NAD_N[c]	NAD	N
m_1_3_biphosphoglycerate_N[c]	1-3-biphosphoglycerate	N
m_NADH_N[c]	NADH	N
m_3_phosphoglycerate_N[c]	3-phosphoglycerate	N
m_2_phosphoglycerate_N[c]	2-phosphoglycerate	N
m_Phosphoenol_pyruvate_N[c]	Phosphoenol-pyruvate	N
m_Pyruvate_N[c]	Pyruvate	N
m_Lactate_N[c]	Lactate	N
m_NAD_NM[c]	NAD	NM
m_Acetyl_CoA_N[c]	Acetyl-CoA	N
m_CO2_N[c]	CO2	N
m_NADH_NM[c]	NADH	NM
m_Oxoloacetate_N[c]	Oxoloacetate	N
m_GTP_N[c]	GTP	N
m_GDP_N[c]	GDP	N
m_2_3_Disphospho_D_glycerate_N[c]	2-3-Disphospho-D-glycerate	N
m_NADP_N[c]	NADP	N
m_6_phosphoglucone_N[c]	6-phosphoglucone	N
m_NADPH_N[c]	NADPH	N
m_6_phosphogluconate_N[c]	6-phosphogluconate	N
m_Ribulose_5_phosphate_N[c]	Ribulose-5-phosphate	N
m_Xylulose_5_phosphate_N[c]	Xylulose-5-phosphate	N
m_Ribose_5_phosphate_N[c]	Ribose-5-phosphate	N
m_Sedoheptulose_7_phosphate_N[c]	Sedoheptulose-7-phosphate	N
m_Erythrose_4_phosphate_N[c]	Erythrose-4-phosphate	N
m_Citrate_N[c]	Citrate	N
m_Cis_aconitate_N[c]	Cis_aconitate	N
m_Isocitrate_N[c]	Isocitrate	N
m_alpha_ketoglutarate_N[c]	alpha-ketoglutarate	N
m_NADP_NM[c]	NADP	NM
m_NADPH_NM[c]	NADPH	NM
m_Succinyl_CoA_N[c]	Succinyl-CoA	N
m_Succinate_N[c]	Succinate	N
m_FAD_NM[c]	FAD	NM
m_Fumarate_N[c]	Fumarate	N
m_FADH2_NM[c]	FADH2	NM
m_Malate_N[c]	Malate	N
m_Ubiquinone_N[c]	Ubiquinone	N
m_Ubiquinol_N[c]	Ubiquinol	N
m_Hc_N[c]	Hc	N
m_CytCox_N[c]	CytCox	N
m_CytCred_N[c]	CytCred	N
m_O2_N[c]	O2	N
m_NH3_N[c]	NH3	N
m_Glutamate_N[c]	Glutamate	N
m_NH3_A[c]	NH3	A
m_Glutamate_A[c]	Glutamate	A
m_Glutamine_A[c]	Glutamine	A
m_Glutamine_N[c]	Glutamine	N
m_GABA_N[c]	GABA	N
m_GABA_A[c]	GABA	A
m_SuccinateSAL_A[c]	SuccinateSAL	A
m_SuccinateSAL_N[c]	SuccinateSAL	N
m_Aspartate_N[c]	Aspartate	N
m_Aspartate_A[c]	Aspartate	A
m_Asparagine_N[c]	Asparagine	N
m_AMP_N[c]	AMP	N
m_Histidine_N[c]	Histidine	N
m_Histamine_N[c]	Histamine	N
m_S_adenosyl_L_methionine_N[c]	S-adenosyl-L-methionine	N
m_S_adenosyl_L_homocysteine_N[c]	S-adenosyl-L-homocysteine	N
m_methylhistamine_N[c]	methylhistamine	N
m_Alanine_N[c]	Alanine	N
m_Alanine_A[c]	Alanine	A
m_3_phosphohydroxypyruvate_A[c]	3-phosphohydroxypyruvate	A
m_3_phospho_serine_A[c]	3_phospho_serine	A
m_Serine_A[c]	Serine	A
m_Serine_N[c]	Serine	N
m_tetrahydrofolate_N[c]	tetrahydrofolate	N
m_Glycine_N[c]	Glycine	N
m_Glycine_A[c]	Glycine	A
m_tetrahydrofolate_A[c]	tetrahydrofolate	A
m_Leucine_A[c]	Leucine	A
m_KIC_A[c]	KIC	A
m_Isovaleryl_CoA_A[c]	Isovaleryl-CoA	A
m_3_methylcrotonyl_Coa_A[c]	3_methylcrotonyl-Coa	A
m_3_methylglutaconyl_Coa_A[c]	3_methylglutaconyl-Coa	A
m_3_hydroxy_3_methylglutaryl_Coa_A[c]	3_hydroxy_3_methylglutaryl-Coa	A
m_Acetoacetate_A[c]	Acetoacetate	A
m_Acetoacetyl_CoA_A[c]	Acetoacetyl-CoA	A
m_KIC_N[c]	KIC	N
m_Leucine_N[c]	Leucine	N
m_Valine_A[c]	Valine	A
m_KIV_A[c]	KIV	A
m_Isobutyryl_CoA_A[c]	Isobutyryl-CoA	A
m_methylacrylyl_CoA_A[c]	methylacrylyl-CoA	A
m_S_3_hydroxy_isobutyryl_CoA_A[c]	S-3-hydroxy-isobutyryl-CoA	A
m_S_3_hydroxy_isobutyrate_A[c]	S-3-hydroxy-isobutyrate	A
m_S_methylmalonate_semialdehyde[c]	S-methylmalonate-semialdehyde	
m_Propionyl_CoA_A[c]	Propionyl-CoA	A
m_S_methylmalonyl_CoA_A[c]	S-methylmalonyl-CoA	A
m_R_methylmalonyl_CoA_A[c]	R-methylmalonyl-CoA	A
m_KIV_N[c]	KIV	N
m_Valine_N[c]	Valine	N
m_Isoleucine_A[c]	Isoleucine	A
m_KMV_A[c]	KMV	A
m_Methylbutyryl_CoA_A[c]	Methylbutyryl-CoA	A
m_E_2_methylcrotonoyl_CoA_A[c]	E-2-methylcrotonoyl-CoA	A
m_2_methyl_3_hydroxybutyryl_CoA_A[c]	2-methyl-3-hydroxybutyryl-CoA	A
m_2_methylacetoacetyl_CoA_A[c]	2-methylacetoacetyl-CoA	A
m_KMV_N[c]	KMV	N
m_Isoleucine_N[c]	Isoleucine	N
m_Lysine_N[c]	Lysine	N
m_Saccharopine_N[c]	Saccharopine	N
m_2_aminoadipate_semialdehyde_N[c]	2-aminoadipate_semialdehyde	N
m_S_2_3_4_5_tetrahydropiperidine_2_carboxylate_N[c]	S-2,3,4,5-tetrahydropiperidine-2-carboxylate	N
m_2_aminoadipate_N[c]	2-aminoadipate	N
m_alpha_ketoadipate_N[c]	alpha-ketoadipate	N
m_glutaryl_CoA_N[c]	glutaryl-CoA	N
m_glutaconyl_CoA_N[c]	glutaconyl-CoA	N
m_crotonyl_CoA_N[c]	crotonyl-CoA	N
m_S_3_hydroxybutanoyl_CoA_N[c]	S-3-hydroxybutanoyl-CoA	N
m_Acetoacetyl_CoA_N[c]	Acetoacetyl-CoA	N
m_Phenylalanine_N[c]	Phenylalanine	N
m_Tetrahydrobiopterin_N[c]	Tetrahydrobiopterin	N
m_Tyrosine_N[c]	Tyrosine	N
m_4_alpha_hydroxy_tetrahydrobiopterin_N[c]	4-alpha-hydroxy-tetrahydrobiopterin	N
m_Dihydrobiopterin_N[c]	Dihydrobiopterin	N
m_L_DOPA_N[c]	L-DOPA	N
m_Dopamine_N[c]	Dopamine	N
m_Norepinephrine_N[c]	Norepinephrine	N
m_Epinephrine_N[c]	Epinephrine	N
m_Dopamine_A[c]	Dopamine	A
m_Norepinephrine_A[c]	Norepinephrine	A
m_Tryptophan_N[c]	Tryptophan	N
m_5_hydroxytryptophan_N[c]	5-hydroxytryptophan	N
m_Seratonin_N[c]	Seratonin	N
m_N_acetyl_serotonin_N[c]	N-acetyl-serotonin	N
m_Melatonin_N[c]	Melatonin	N
m_Choline_N[c]	Choline	N
m_Acetylcholine_N[c]	Acetylcholine	N
m_S_1_pyrroline_5_carboxylate_A[c]	S-1-pyrroline-5-carboxylate	A
m_proline_A[c]	proline	A
m_methionine[c]	methionine	
m_methionine_A[c]	methionine	A
m_S_adenosyl_L_methionine_A[c]	S-adenosyl-L-methionine	A
m_S_adenosyl_L_homocysteine_A[c]	S-adenosyl-L-homocysteine	A
m_L_homocysteine_A[c]	L-homocysteine	A
m_adenosine_A[c]	adenosine	A
m_L_cystathionine_A[c]	L-cystathionine	A
m_2_oxobutanoate_A[c]	2-oxobutanoate	A
m_Cysteine_A[c]	Cysteine	A
m_methionine_N[c]	methionine	N
m_L_homocysteine_N[c]	L-homocysteine	N
m_adenosine_N[c]	adenosine	N
m_L_cystathionine_N[c]	L-cystathionine	N
m_2_oxobutanoate_N[c]	2-oxobutanoate	N
m_Cysteine_N[c]	Cysteine	N
m_threonine[c]	threonine	
m_threonine_A[c]	threonine	A
m_2_amino_3_oxobutanoate_A[c]	2-amino-3-oxobutanoate	A
m_threonine_N[c]	threonine	N
m_2_amino_3_oxobutanoate_N[c]	2-amino-3-oxobutanoate	N
m_s3_hydroxy_3_methylglutaryl_Coa_A[c]	s3_hydroxy_3_methylglutaryl-Coa	A
m_R_mevalonate_A[c]	R-mevalonate	A
m_mevalonate_5_phosphate_A[c]	mevalonate-5-phosphate	A
m_mevalonate_diphosphate_A[c]	mevalonate-diphosphate	A
m_isopentenyl_diphosphate_A[c]	isopentenyl_diphosphate	A
m_dimethylallyl_diphosphate_A[c]	dimethylallyl_diphosphate	A
m_geranyl_diphosphate_A[c]	geranyl_diphosphate	A
m_2E_6E_farnesyl_diphosphate_A[c]	2E_6E_farnesyl_diphosphate	A
m_presqualene_diphosphate_A[c]	presqualene_diphosphate	A
m_squalene_A[c]	squalene	A
m_S_2_3_epoxysqualene_A[c]	S_2_3_epoxysqualene	A
m_lanosterol_A[c]	lanosterol	A
m_4_4_dimethyl_14alpha_hydroxymethyl_5alpha_cholesta_8_24_dien_3beta_ol_A[c]	4-4-dimethyl-14alpha-hydroxymethyl-5alpha-cholesta-8-24-dien-3beta-ol	A
m_4_4_dimethyl_14alpha_formyl_5alpha_cholesta_8_24_dien_3beta_ol_A[c]	4-4-dimethyl-14alpha-formyl-5alpha-cholesta-8-24-dien-3beta-ol	A
m_4_4_dimethyl_5_alpha_cholesta_8_14_24_trien_3_beta_ol_A[c]	4-4-dimethyl-5-alpha-cholesta-8-14-24-trien-3-beta-ol	A
m_formate_A[c]	formate	A
m_4_4_dimethylzymosterol_A[c]	4_4-dimethylzymosterol	A
m_4alpha_hydroxymethyl_4beta_methyl_5alpha_cholesta_8_24_dien_3beta_ol_A[c]	4alpha-hydroxymethyl-4beta-methyl-5alpha-cholesta-8-24-dien-3beta-ol	A
m_4alpha_formyl_4beta_methyl_5alpha_cholesta_8_24_dien_3beta_ol_A[c]	4alpha-formyl-4beta-methyl-5alpha-cholesta-8-24-dien-3beta-ol	A
m_4alpha_carboxy_4beta_methyl_5alpha_cholesta_8_24_dien_3beta_ol_A[c]	4alpha-carboxy-4beta-methyl-5alpha-cholesta-8-24-dien-3beta-ol	A
m_3_keto_4_methylzymosterol_A[c]	3-keto-4-methylzymosterol	A
m_4alpha_methyl_zymosterol_A[c]	4alpha-methyl-zymosterol	A
m_4alpha_hydroxymethyl_5alpha_cholesta_8_24_dien_3beta_ol_A[c]	4alpha-hydroxymethyl-5alpha-cholesta-8-24-dien-3beta-ol	A
m_4alpha_formyl_5alpha_cholesta_8_24_dien_3beta_ol_A[c]	4alpha-formyl-5alpha-cholesta-8-24-dien-3beta-ol	A
m_4alpha_carboxy_5alpha_cholesta_8_24_dien_3beta_ol_A[c]	4alpha-carboxy-5alpha-cholesta-8-24-dien-3beta-ol	A
m_5alpha_cholesta_8_24_dien_3_one_A[c]	5alpha-cholesta-8-24-dien-3-one	A
m_zymosterol_A[c]	zymosterol	A
m_5alpha_cholesta_7_24_dien_3beta_ol_A[c]	5alpha-cholesta-7-24-dien-3beta-ol	A
m_7_dehydrodesmosterol_A[c]	7-dehydrodesmosterol	A
m_desmosterol_A[c]	desmosterol	A
m_Cholesterol_A[c]	Cholesterol	A
m_lathosterol_A[c]	lathosterol	A
m_7_dehydro_cholesterol_A[c]	7-dehydro-cholesterol	A
m_24_25_dihydrolanosterol_A[c]	24-25-dihydrolanosterol	A
m_4_4_dimethyl_14alpha_hydroxymethyl_5alpha_cholesta_8_en_3beta_ol_A[c]	4-4-dimethyl-14alpha-hydroxymethyl-5alpha-cholesta-8-en-3beta-ol	A
m_4_4_dimethyl_14alpha_formyl_5alpha_cholesta_8_en_3beta_ol_A[c]	4-4-dimethyl-14alpha-formyl-5alpha-cholesta-8-en-3beta-ol	A
m_4_4_dimethyl_5_alpha_cholesta_8_14_dien_3_beta_ol_A[c]	4-4-dimethyl-5-alpha-cholesta-8-14-dien-3-beta-ol	A
m_4_4_dimethyl_5alpha_cholesta_8_en_3_beta_ol_A[c]	4-4-dimethyl-5alpha-cholesta-8-en-3-beta-ol	A
m_4alpha_hydroxymethyl_4beta_methyl_5alpha_cholesta_8_en_3beta_ol_A[c]	4alpha-hydroxymethyl-4beta-methyl-5alpha-cholesta-8-en-3beta-ol	A
m_4alpha_formyl_4beta_methyl_5alpha_cholesta_8_en_3beta_ol_A[c]	4alpha-formyl-4beta-methyl-5alpha-cholesta-8-en-3beta-ol	A
m_4alpha_carboxy_4beta_methyl_5alpha_cholesta_8_en_3beta_ol_A[c]	4alpha-carboxy-4beta-methyl-5alpha-cholesta-8-en-3beta-ol	A
m_4alpha_methyl_5alpha_cholesta_8_en_3_one_A[c]	4alpha-methyl-5alpha-cholesta-8-en-3-one	A
m_4alpha_methyl_cholesta_8_enol_A[c]	4alpha-methyl-cholesta-8-enol	A
m_4alpha_hydroxymethyl_5alpha_cholesta_8_en_3beta_ol_A[c]	4alpha-hydroxymethyl-5alpha-cholesta-8-en-3beta-ol	A
m_4alpha_formyl_5alpha_cholesta_8_en_3beta_ol_A[c]	4alpha-formyl-5alpha-cholesta-8-en-3beta-ol	A
m_4alpha_carboxy_5alpha_cholesta_8_en_3beta_ol_A[c]	4alpha-carboxy-5alpha-cholesta-8-en-3beta-ol	A
m_5alpha_cholesta_8_en_3_one_A[c]	5alpha-cholesta-8-en-3-one	A
m_zymostenol_A[c]	zymostenol	A
m_Cholesterol_N[c]	Cholesterol	N
m_Acetoacetyl_acp_A[c]	Acetoacetyl-acp	A
m_R_3_hydroxybutanoyl_acp_A[c]	R-3-hydroxybutanoyl-acp	A
m_Crotonyl_acp_A[c]	Crotonyl-acp	A
m_Butyryl_acp_A[c]	Butyryl-acp	A
m_Malonyl_CoA_A[c]	Malonyl-CoA	A
m_3_oxo_hexanoyl_acp_A[c]	3-oxo-hexanoyl-acp	A
m_R_3_hydroxyhexanoyl_acp_A[c]	R-3-hydroxyhexanoyl-acp	A
m_trans_hex_2_enoyl_acp_A[c]	trans_hex-2-enoyl-acp	A
m_Hexanoyl_acp_A[c]	Hexanoyl-acp	A
m_3_oxo_octanoyl_acp_A[c]	3-oxo-octanoyl-acp	A
m_R_3_hydroxyoctanoyl_acp_A[c]	R-3-hydroxyoctanoyl-acp	A
m_trans_oct_2_enoyl_acp_A[c]	trans_oct-2-enoyl-acp	A
m_Octanoyl_acp_A[c]	Octanoyl-acp	A
m_3_oxo_decanoyl_acp_A[c]	3-oxo-decanoyl-acp	A
m_R_3_hydroxydecanoyl_acp_A[c]	R-3-hydroxydecanoyl-acp	A
m_trans_delta2_decenoyl_acp_A[c]	trans-delta2-decenoyl-acp	A
m_Decanoyl_acp_A[c]	Decanoyl-acp	A
m_3_oxo_dodecanoyl_acp_A[c]	3-oxo-dodecanoyl-acp	A
m_R_3_hydroxydodecanoyl_acp_A[c]	R-3-hydroxydodecanoyl-acp	A
m_trans_dodec_2_enoyl_acp_A[c]	trans_dodec-2-enoyl-acp	A
m_Dodecanoyl_acp_A[c]	Dodecanoyl-acp	A
m_Laurate_A[c]	Laurate	A
m_3_oxo_myristoyl_acp_A[c]	3-oxo-myristoyl-acp	A
m_3R_3_hydroxymyristoyl_acp_A[c]	3R-3-hydroxymyristoyl-acp	A
m_trans_tetradec_2_enoyl_acp_A[c]	trans_tetradec-2-enoyl-acp	A
m_Myristoyl_acp_A[c]	Myristoyl-acp	A
m_3_oxo_palmitoyl_acp_A[c]	3-oxo-palmitoyl-acp	A
m_R_3_hydroxypalmitoyl_acp_A[c]	R-3-hydroxypalmitoyl-acp	A
m_trans_hexadecenoyl_acp_A[c]	trans_hexadecenoyl-acp	A
m_Palmitoyl_acp_A[c]	Palmitoyl-acp	A
m_Palmitate_A[c]	Palmitate	A
m_Acetyl_acp_A[c]	Acetyl-acp	A
m_Malonyl_acp_A[c]	Malonyl-acp	A
m_Palmitoyl_CoA_A[c]	Palmitoyl-CoA	A
m_AMP_A[c]	AMP	A
m_3_oxo_stearoyl_CoA_A[c]	3-oxo-stearoyl-CoA	A
m_3_hydroxy_stearoyl_CoA_A[c]	3-hydroxy-stearoyl-CoA	A
m_trans_2_3_stearoyl_CoA_A[c]	trans-2-3-stearoyl-CoA	A
m_Stearoyl_CoA_A[c]	Stearoyl-CoA	A
m_Stearate_A[c]	Stearate	A
m_Oleoyl_CoA_A[c]	Oleoyl-CoA	A
m_Oleate_A[c]	Oleate	A
m_Linoleate_A[c]	Linoleate	A
m_Arachidonate_A[c]	Arachidonate	A
m_Linolenate_A[c]	Linolenate	A
m_Decosahexenoate_A[c]	Decosahexenoate	A
m_Acetoacetyl_acp_N[c]	Acetoacetyl-acp	N
m_R_3_hydroxybutanoyl_acp_N[c]	R-3-hydroxybutanoyl-acp	N
m_Crotonyl_acp_N[c]	Crotonyl-acp	N
m_Butyryl_acp_N[c]	Butyryl-acp	N
m_Malonyl_CoA_N[c]	Malonyl-CoA	N
m_3_oxo_hexanoyl_acp_N[c]	3-oxo-hexanoyl-acp	N
m_R_3_hydroxyhexanoyl_acp_N[c]	R-3-hydroxyhexanoyl-acp	N
m_trans_hex_2_enoyl_acp_N[c]	trans_hex-2-enoyl-acp	N
m_Hexanoyl_acp_N[c]	Hexanoyl-acp	N
m_3_oxo_octanoyl_acp_N[c]	3-oxo-octanoyl-acp	N
m_R_3_hydroxyoctanoyl_acp_N[c]	R-3-hydroxyoctanoyl-acp	N
m_trans_oct_2_enoyl_acp_N[c]	trans_oct-2-enoyl-acp	N
m_Octanoyl_acp_N[c]	Octanoyl-acp	N
m_3_oxo_decanoyl_acp_N[c]	3-oxo-decanoyl-acp	N
m_R_3_hydroxydecanoyl_acp_N[c]	R-3-hydroxydecanoyl-acp	N
m_trans_delta2_decenoyl_acp_N[c]	trans-delta2-decenoyl-acp	N
m_Decanoyl_acp_N[c]	Decanoyl-acp	N
m_3_oxo_dodecanoyl_acp_N[c]	3-oxo-dodecanoyl-acp	N
m_R_3_hydroxydodecanoyl_acp_N[c]	R-3-hydroxydodecanoyl-acp	N
m_trans_dodec_2_enoyl_acp_N[c]	trans_dodec-2-enoyl-acp	N
m_Dodecanoyl_acp_N[c]	Dodecanoyl-acp	N
m_Laurate_N[c]	Laurate	N
m_3_oxo_myristoyl_acp_N[c]	3-oxo-myristoyl-acp	N
m_3R_3_hydroxymyristoyl_acp_N[c]	3R-3-hydroxymyristoyl-acp	N
m_trans_tetradec_2_enoyl_acp_N[c]	trans_tetradec-2-enoyl-acp	N
m_Myristoyl_acp_N[c]	Myristoyl-acp	N
m_3_oxo_palmitoyl_acp_N[c]	3-oxo-palmitoyl-acp	N
m_R_3_hydroxypalmitoyl_acp_N[c]	R-3-hydroxypalmitoyl-acp	N
m_trans_hexadecenoyl_acp_N[c]	trans_hexadecenoyl-acp	N
m_Palmitoyl_acp_N[c]	Palmitoyl-acp	N
m_Palmitate_N[c]	Palmitate	N
m_Acetyl_acp_N[c]	Acetyl-acp	N
m_Malonyl_acp_N[c]	Malonyl-acp	N
m_Bicarbonate_N[c]	Bicarbonate	N
m_Palmitoyl_CoA_N[c]	Palmitoyl-CoA	N
m_3_oxo_stearoyl_CoA_N[c]	3-oxo-stearoyl-CoA	N
m_3_hydroxy_stearoyl_CoA_N[c]	3-hydroxy-stearoyl-CoA	N
m_trans_2_3_stearoyl_CoA_N[c]	trans-2-3-stearoyl-CoA	N
m_Stearoyl_CoA_N[c]	Stearoyl-CoA	N
m_Stearate_N[c]	Stearate	N
m_Oleoyl_CoA_N[c]	Oleoyl-CoA	N
m_Oleate_N[c]	Oleate	N
m_Arachidonate_N[c]	Arachidonate	N
m_Decosahexenoate_N[c]	Decosahexenoate	N
m_FattyAcid_A[c]	FattyAcid	A
m_FattyAcid_N[c]	FattyAcid	N
m_Glycerol_3_phosphate_A[c]	Glycerol-3-phosphate	A
m_Glycerol_3_phosphate_N[c]	Glycerol-3-phosphate	N
m_Ethanolamine_A[c]	Ethanolamine	A
m_Phosphoryl_ethanolamine_A[c]	Phosphoryl-ethanolamine	A
m_CTP_A[c]	CTP	A
m_CDP_ethanolamine_A[c]	CDP-ethanolamine	A
m_1_2_diacylglycerol_A[c]	1_2-diacylglycerol	A
m_Phosphatidyl_ethanolamine_A[c]	Phosphatidyl-ethanolamine	A
m_CMP_A[c]	CMP	A
m_Phosphatidyl_choline_A[c]	Phosphatidyl-choline	A
m_Phosphatidyl_serine_A[c]	Phosphatidyl-serine	A
m_Ethanolamine_N[c]	Ethanolamine	N
m_Phosphoryl_ethanolamine_N[c]	Phosphoryl-ethanolamine	N
m_CTP_N[c]	CTP	N
m_CDP_ethanolamine_N[c]	CDP-ethanolamine	N
m_1_2_diacylglycerol_N[c]	1_2-diacylglycerol	N
m_Phosphatidyl_ethanolamine_N[c]	Phosphatidyl-ethanolamine	N
m_CMP_N[c]	CMP	N
m_Phosphatidyl_choline_N[c]	Phosphatidyl-choline	N
m_Phosphatidyl_serine_N[c]	Phosphatidyl-serine	N
m_Choline_A[c]	Choline	A
m_Phosphoryl_choline_A[c]	Phosphoryl-choline	A
m_CDP_choline_A[c]	CDP-choline	A
m_Phosphoryl_choline_N[c]	Phosphoryl-choline	N
m_CDP_choline_N[c]	CDP-choline	N
m_CDP_diacylglycerol_A[c]	CDP-diacylglycerol	A
m_phosphatidylglycerol_phosphate_A[c]	phosphatidylglycerol-phosphate	A
m_phosphatidyl_glycerol_A[c]	phosphatidyl-glycerol	A
m_cardiolipin_A[c]	cardiolipin	A
m_CDP_diacylglycerol_N[c]	CDP-diacylglycerol	N
m_phosphatidylglycerol_phosphate_N[c]	phosphatidylglycerol-phosphate	N
m_phosphatidyl_glycerol_N[c]	phosphatidyl-glycerol	N
m_cardiolipin_N[c]	cardiolipin	N
m_3_dehydrosphinganine_A[c]	3-dehydrosphinganine	A
m_sphinganine_A[c]	sphinganine	A
m_dihydroceramide_A[c]	dihydroceramide	A
m_ceramide_A[c]	ceramide	A
m_sphingomyelin_A[c]	sphingomyelin	A
m_3_dehydrosphinganine_N[c]	3-dehydrosphinganine	N
m_sphinganine_N[c]	sphinganine	N
m_dihydroceramide_N[c]	dihydroceramide	N
m_ceramide_N[c]	ceramide	N
m_sphingomyelin_N[c]	sphingomyelin	N
m_1_acyl_sn_glycerol_3_phosphate_A[c]	1-acyl-sn-glycerol-3-phosphate	A
m_Phosphatidate_A[c]	Phosphatidate	A
m_1_acyl_sn_glycerol_3_phosphate_N[c]	1-acyl-sn-glycerol-3-phosphate	N
m_Phosphatidate_N[c]	Phosphatidate	N
m_myo_inositol[c]	myo-inositol	
m_myo_inositol_A[c]	myo-inositol	A
m_phosphatidyl_inositol_A[c]	phosphatidyl-inositol	A
m_phosphatidyl_1D_myo_inositol_4_phosphate_A[c]	phosphatidyl-1D-myo-inositol-4-phosphate	A
m_phosphatidyl_1D_myo_inositol_4_5_bisphosphate_A[c]	phosphatidyl-1D-myo-inositol-4-5-bisphosphate	A
m_myo_inositol_1_4_5_trisphosphate_A[c]	myo-inositol-(1-4-5)-trisphosphate	A
m_myo_inositol_1_4_bisphosphate_A[c]	myo-inositol-(1-4)-bisphosphate	A
m_myo_inositol_4_monophosphate_A[c]	myo-inositol-(4)-monophosphate	A
m_myo_inositol_1_3_4_5_tetrakisphosphate_A[c]	myo-inositol-(1-3-4-5)-tetrakisphosphate	A
m_myo_inositol_1_3_4_trisphosphate_A[c]	myo-inositol-(1-3-4)-trisphosphate	A
m_myo_inositol_3_4_bisphosphate_A[c]	myo-inositol-(3-4)-bisphosphate	A
m_myo_inositol_3_monophosphate_A[c]	myo-inositol-3-monophosphate	A
m_myo_inositol_N[c]	myo-inositol	N
m_phosphatidyl_inositol_N[c]	phosphatidyl-inositol	N
m_phosphatidyl_1D_myo_inositol_4_phosphate_N[c]	phosphatidyl-1D-myo-inositol-4-phosphate	N
m_phosphatidyl_1D_myo_inositol_4_5_bisphosphate_N[c]	phosphatidyl-1D-myo-inositol-4-5-bisphosphate	N
m_myo_inositol_1_4_5_trisphosphate_N[c]	myo-inositol-(1-4-5)-trisphosphate	N
m_myo_inositol_1_4_bisphosphate_N[c]	myo-inositol-(1-4)-bisphosphate	N
m_myo_inositol_4_monophosphate_N[c]	myo-inositol-(4)-monophosphate	N
m_myo_inositol_1_3_4_5_tetrakisphosphate_N[c]	myo-inositol-(1-3-4-5)-tetrakisphosphate	N
m_myo_inositol_1_3_4_trisphosphate_N[c]	myo-inositol-(1-3-4)-trisphosphate	N
m_myo_inositol_3_4_bisphosphate_N[c]	myo-inositol-(3-4)-bisphosphate	N
m_myo_inositol_3_monophosphate_N[c]	myo-inositol-3-monophosphate	N
m_Lipid_A[c]	Lipid	A
m_Lipid_N[c]	Lipid	N
m_Cystine_A[c]	Cystine	A
m_L_gamma_glutamylcysteine_A[c]	L-gamma-glutamylcysteine	A
m_ReducedGlutathione_A[c]	ReducedGlutathione	A
m_H2O2_A[c]	H2O2	A
m_OxidizedGlutathione_A[c]	OxidizedGlutathione	A
m_CysteinylGlycine_A[c]	CysteinylGlycine	A
m_CysteinylGlycine_N[c]	CysteinylGlycine	N
m_L_gamma_glutamylcysteine_N[c]	L-gamma-glutamylcysteine	N
m_ReducedGlutathione_N[c]	ReducedGlutathione	N
m_H2O2_N[c]	H2O2	N
m_OxidizedGlutathione_N[c]	OxidizedGlutathione	N
m_Glycogen[c]	Glycogen	
m_Glucose_1_phosphate_A[c]	Glucose-1-phosphate	A
m_BHB[c]	BHB	
m_BHB_A[c]	BHB	A
m_BHB_N[c]	BHB	N
m_Acetoacetate[c]	Acetoacetate	
m_Acetoacetate_N[c]	Acetoacetate	N
m_Ornithine[c]	Ornithine	
m_Ornithine_A[c]	Ornithine	A
m_Arginine_A[c]	Arginine	A
m_Agmatine_A[c]	Agmatine	A
m_Urea_A[c]	Urea	A
m_Glutamate_semialdehyde_A[c]	Glutamate_semialdehyde	A
m_Ornithine_N[c]	Ornithine	N
m_Arginine_N[c]	Arginine	N
m_Agmatine_N[c]	Agmatine	N
m_Putrescine_N[c]	Putrescine	N
m_Urea_N[c]	Urea	N
m_Citrulline_N[c]	Citrulline	N
m_L_Arginino_Succinate_N[c]	L_Arginino_Succinate	N
m_Putrescine_A[c]	Putrescine	A
m_N_acetylputrescine_A[c]	N-acetylputrescine	A
m_Acetamidobutanal_A[c]	Acetamidobutanal	A
m_Acetamidobutanoate_A[c]	Acetamidobutanoate	A
m_S_adenosyl_L_methioninamine_A[c]	S-adenosyl-L-methioninamine	A
m_S_adenosyl_L_methioninamine_N[c]	S-adenosyl-L-methioninamine	N
m_Spermidine_N[c]	Spermidine	N
m_S_methyl_5_thioadenosine_N[c]	S-methyl-5-thioadenosine	N
m_Spermine_N[c]	Spermine	N
m_N_1_Acetylspermine_N[c]	N_1_Acetylspermine	N
m_N_1_Acetylspermidine_N[c]	N_1_Acetylspermidine	N
m_Guanidinoacetate_A[c]	Guanidinoacetate	A
m_Creatine_A[c]	Creatine	A
m_CreatinePhosphate_A[c]	CreatinePhosphate	A
m_Guanidinoacetate_N[c]	Guanidinoacetate	N
m_Creatine_N[c]	Creatine	N
m_CreatinePhosphate_N[c]	CreatinePhosphate	N
m_5_amino_levulinate_A[c]	5-amino-levulinate	A
m_porphobilinogen_A[c]	porphobilinogen	A
m_hydroxymethylbilane_A[c]	hydroxymethylbilane	A
m_uroporphyrinogen_A[c]	uroporphyrinogen	A
m_coproporphyrinogen_A[c]	coproporphyrinogen	A
m_protoporphyrinogen_A[c]	protoporphyrinogen	A
m_protoporphyrin_A[c]	protoporphyrin	A
m_protoheme_A[c]	protoheme	A
m_biliverdin_A[c]	biliverdin	A
m_bilirubin_A[c]	bilirubin	A
m_5_amino_levulinate_N[c]	5-amino-levulinate	N
m_porphobilinogen_N[c]	porphobilinogen	N
m_hydroxymethylbilane_N[c]	hydroxymethylbilane	N
m_uroporphyrinogen_N[c]	uroporphyrinogen	N
m_coproporphyrinogen_N[c]	coproporphyrinogen	N
m_protoporphyrinogen_N[c]	protoporphyrinogen	N
m_protoporphyrin_N[c]	protoporphyrin	N
m_protoheme_N[c]	protoheme	N
m_biliverdin_N[c]	biliverdin	N
m_bilirubin_N[c]	bilirubin	N
m_adenosine[c]	adenosine	
m_guanosine[c]	guanosine	
m_guanosine_A[c]	guanosine	A
m_ribose_1_phosphate_A[c]	ribose-1-phosphate	A
m_guanine_A[c]	guanine	A
m_5_phospho_D_ribose_1_diphosphate_A[c]	5-phospho-D-ribose-1-diphosphate	A
m_GMP_A[c]	GMP	A
m_uridine[c]	uridine	
m_uridine_A[c]	uridine	A
m_UTP_A[c]	UTP	A
m_UDP_A[c]	UDP	A
m_UMP_A[c]	UMP	A
m_uracil_A[c]	uracil	A
m_cytidine[c]	cytidine	
m_cytidine_A[c]	cytidine	A
m_CDP_A[c]	CDP	A
m_guanosine_N[c]	guanosine	N
m_ribose_1_phosphate_N[c]	ribose-1-phosphate	N
m_guanine_N[c]	guanine	N
m_5_phospho_D_ribose_1_diphosphate_N[c]	5-phospho-D-ribose-1-diphosphate	N
m_GMP_N[c]	GMP	N
m_uridine_N[c]	uridine	N
m_UTP_N[c]	UTP	N
m_UDP_N[c]	UDP	N
m_UMP_N[c]	UMP	N
m_uracil_N[c]	uracil	N
m_cytidine_N[c]	cytidine	N
m_CDP_N[c]	CDP	N
